Ctrl+2	Go to Bookmark 2	Undefined
Ctrl+Shift+2	Toggle Bookmark 2	Undefined
Ctrl+Shift+6	Toggle Bookmark 6	Undefined
Ctrl+A	Select All	IDE
Ctrl+B	Go to Declaration or Usages	Undefined
Ctrl+C	Copy	IDE
Ctrl+D	Compare Files	Undefined
Ctrl+E	Toggle Changed Only Files	Undefined
Ctrl+F	Go To Hash/Branch/Tag	Undefined
Ctrl+G	Go to Line/Column...	Undefined
Ctrl+H	Base on This Class	Undefined
Ctrl+I	Implement Methods...	Undefined
Ctrl+J	Insert Live Template...	Undefined
Ctrl+K	Commit...	Undefined
Ctrl+L	Find Next / Move to Next Occurrence	Undefined
Ctrl+M	Commit Message History	Undefined
Ctrl+N	New Folder...	Undefined
Ctrl+O	Override Methods...	Undefined
Ctrl+P	Show/Hide path text	Undefined
Ctrl+Q	Quick Documentation	Undefined
Ctrl+R	Replace...	Undefined
Ctrl+S	Save All	Undefined
Ctrl+T	Update Project	Undefined
Ctrl+U	Go to Super Method	Undefined
Ctrl+V	Paste	IDE
Ctrl+W	Extend Selection	Undefined
Ctrl+X	Cut	IDE
Ctrl+Y	Delete Line	IDE
Ctrl+[	Move Caret to Code Block Start	Undefined
Ctrl+]	Move Caret to Code Block End	Undefined
